110011111111111111111111111111111111111111111000000000
110011000000000000000000111111111111111111111000000000
110011000000000000000000000000000001111111111000000000
110011001111111111111100000000000001111111111000000000
110011001111111111111100111100111001111111111000000000
110011001111111111111100111100111001111111111000000000
110011001111111111111100111100111000000000000000000000
110011001110000000000000111100111000000000000000000000
110011001110000000000000111100111001111111111000000000
110011001110011111111111111100111001111111111000000000
110011000000000000000000000000000001111111111000000000
110000000000000000000000000000000001111111111000000000
110000000011111111111111111111111000000001111000000000
111111110011111111111111111111111000000001111000000000
111111110011111111111111111111111001111001111000000000
111111110011111111111111111111111001111001111000000000
110000000000000000000000011111111001111001111000000000
110000000000000000000000011111111001111001111000000000
110000111111111111100110000011111001111001111000000000
110000111111111111100110000011111001111000000000000000
110000000000000001100110010000000001111000000000000000
110000000000000000000110010000000001111111111000000000
111111111111111000000110010011111111111111111000000000
111111111111111001111110010011111111111111111000000000
110000000000000001111110000011111111111111111000000000
110000000000000001111110000011111111111111111000000000
110011111111111111111111111111111111111111111000000000