DRURDLDRURDRW
URULURDRURURDRW
110011111111111111111111111111111111111111111333333333
110011000000000000000000111111111111111111111333333333
110011000000000000000000222200000001111111111333333333
110011001111111111111100222200000001111111111333333333
110011001111111111111100111100111001111111111333333333
110011001111111111111100111100111001111111111333333333
110011001111111111111100111100111000000000000000033333
110011001110000000000000111100111000000000000000033333
110011001110000000000000111100111221111111111333333333
110011001110011111111111111100111221111111111333333333
110011002220000000000000000000222221111111111333333333
110000002220000000000000000000222221111111111333333333
110000002211111111111111111111111000000001111333333333
111111112211111111111111111111111000000001111333333333
111111112211111111111111111111111001111001111333333333
111111112211111111111111111111111001111001111333333333
110000000000000000000000011111111001111001111333333333
110000000000000000000000011111111001111001111333333333
110022111111111111122110022211111001111001111333333333
110022111111111111122110022211111001111000000000033333
110000000000000001122110010000000001111000000000033333
110000000000000002222110010000000001111111111333333333
111111111111111002222110010011111111111111111333333333
111111111111111001111110010011111111111111111333333333
110000000000000001111110000011111111111111111333333333
110000000000000001111110000011111111111111111333333333
110011111111111111111111111111111111111111111333333333