11001 11111 11111 11111 11111 11111 11111 11111 11111
11001 10000 00000 00000 00001 11111 11111 11111 11111
11001 10000 00000 00000 00000 00000 00000 11111 11111
11001 10011 11111 11111 11000 00000 00000 11111 11111
11001 10011 11111 11111 11001 11100 11100 11111 11111
11001 10011 11111 11111 11001 11100 11100 11111 11111
11001 10011 11111 11111 11001 11100 11100 00000 00000
11001 10011 10000 00000 00001 11100 11100 00000 00000
11001 10011 10000 00000 00001 11100 11100 11111 11111
11001 10011 10011 11111 11111 11100 11100 11111 11111
11001 10000 00000 00000 00000 00000 00000 11111 11111
11000 00000 00000 00000 00000 00000 00000 11111 11111
11000 00000 11111 11111 11111 11111 11100 00000 01111
11111 11100 11111 11111 11111 11111 11100 00000 01111
11111 11100 11111 11111 11111 11111 11100 11110 01111
11111 11100 11111 11111 11111 11111 11100 11110 01111
11000 00000 00000 00000 00000 11111 11100 11110 01111
11000 00000 00000 00000 00000 11111 11100 11110 01111
11000 01111 11111 11110 01100 00011 11100 11110 01111
11000 01111 11111 11110 01100 00011 11100 11110 00000
11000 00000 00000 00110 01100 10000 00000 11110 00000
11000 00000 00000 00000 01100 10000 00000 11111 11111
11111 11111 11111 00000 01100 10011 11111 11111 11111
11111 11111 11111 00111 11100 10011 11111 11111 11111
11000 00000 00000 00111 11100 00011 11111 11111 11111
11000 00000 00000 00111 11100 00011 11111 11111 11111
11001 11111 11111 11111 11111 11111 11111 11111 11111